First	Last
Abby	Kuss
Al	Frecso
Allan	Wrench
Ally	Gator
Alma	Frienzergon
Anita	Job
Anne	Dewey
Arial	Photo
Artie	Choke
Barb 	Dwyer
Barb	Barion
Barry	DeHatchett
Bette	Alott
Bette	Itall
Bill	Melator
Bo	Enarreau
Bob	Enweave
Cam	Payne
Cam	Rha
Candi	Kane
Carol	Ling
Carrie	Dababbi
Chris	Peanugget
Chuck	Itupp
Dan	Delyons
Dustin	DeWinned
Elieen	Touda-Wright
Erin	Detyers
Erua	Quittin
Euron	Tasomthin
Gus	Toffwind
Hank	Erchief
Isabelle	Gunnering
Jack	O'Lantern
Jean	Poole
Joe	King
Justin	Case
Kenny	Pas-D'course
Kent	Belevit
Kurt	Tain
Lee	Hvmeehom
Les	Ismoore
Lisa	Karfurless
Mark	Itdowne
Martin	Eyezing
Mary	Melator
Mary	Mi
Max	Emumm
Mike 	Rophone
Misty	Meadows
Nat	Tural
Oliver	Stuffismission
Oren	Jouglad
Otto	Moni
Patty	O'Furniture
Penny	Pincher
Pete	Moss
Phil	Meaup
Ray	Ovlight
Rose	Abov-Duresst
Ross	Tefarian
Rowan	Deboat
Sal	Boat
Sal	Ladd
Sally	Mander
Sandy	Beeches
Sara	Bellum
Sara	Docktur-Indahaus
Sara	Isnomor
Seymour	Ofewe
Sonny	Shores
Tally	Itupp
Tim	Pani
Tuck	Androll
Ty	Anott
Victor	Edance
Victor	Rhee
Willie	Pas-D'course
Willie	Work
Yolanda	Smyland
